HTML - its the language of the websites
CSS - in websites, if the file that styles your webpage, like colors, size of letters, etc
Javascript - its the language that add interactivity to your website


Database - (its where your data is stored, its what makes your website remember things) you can think of it as a collection excel files
  database tables - you can think of it as a single excel file.
  database columns - like excel columns (its data of the same type)
  database rows - its like a line in an excel file, its a collection of data.
  
SQL - its the language to comunicate with the database
  
scriptinng languages - Ruby in an example of a scripting language, its responsible to generate HTML, and to get data from a database.

---------------------------------------------------------

linux - its the program that operates your computer, its also the language of the computer (behind the scenes)

--------------------------------------------------------- about programing languages


variables - are used to store data. example name = 'brian'
functions - are reusable chuncks code that does what you want. example:  save_user_to_database
classes - are reusable chuncks of variables and functions grouped together
objects - they are created using a 'class'. example: 'ferrari' is an object created with a 'car' class.


getter function - is a function that gets a value
setter function - is a function that sets a value

argument, parameters - is data that you pass to your function so the function can work with that data
callback function - is a function passed as a parameter to another function


inheritance - when a class gets variables and functions from another class

instance - its what is created with a class, the same as the 'object'

instance variables - its variables that belong only to an instance ('object')
instance functions - its functions that belong only to an instance ('object')

class variables - its variables that belong only to a class 
class functions - its functions that belong only to an class 


Instantiation -
Declaration -
Closure - 
Scope -
modularity -
pass by reference - 
pass by value - 
function, method, routine, action - 
variable, field, column - 
parameter, argument - 
